Griekse mitologie


   Griekse mitologie is die versamelde legendes oor Griekse gode en
   godinne asook antieke helde en heldinne. Hierdie legendes is
   oorspronklik geskep en versprei in die mondeling-poëtiese tradisie. Die
   oorblywende bronne van Griekse mitologie is transkripsies van gesproke
   woord, of is latere letterkundige verwerkings.

[wysig] Oorsprong

   Griekse Mitologie is al wat oor gebly het van die Griekse geloof van
   ongeveer 1 200 v.C. Die Gode waaraan hulle geglo het was die Olimpiads
   genoem.

[wysig] Griekse mitologiese figure

     * Aphrodite - Godin van liefde
     * Apollo - Seun van Zeus
     * Ares - God van oorlog
     * Artemis - Dogter van Zeus
     * Athene - Die Berwer
     * Cheiro - Die Centaur
     * Circe - Die verwyte goding
     * Demeter - Godin van die oes
     * Dione - Die ma van Aphrodite (in die Ilias)
     * Enyo - Een van die grys sisters
     * Eos - Godin van die sonsopkoms
     * Erida - Die godin van Haat
     * Erinyes - Die vervolgers van sterflike mans en vrouens wat die
       "natuurlike" wette breeklaws
     * Eris - Tweeling sister van Ares
     * Eros - Boogskutter van liefde
     * Eurynome - Ma van Genade
     * Fates - Die drie witgeklede personifikasies van die noodlot
     * Gorgon - 'n Vroulike monster met skerp tande en hare wat bestaan
       het uit lewendige, giftige slange. Medusa was die menslike weergawe
       van die Gorgon.
     * Graces - Mag hulle jou seën
     * Hades - God van die onderwêreld
     * Hebe - Vrou van Herakles
     * Helios - Die son
     * Hephaistos - God van die Smit
     * Hera - Godin van die huwelik
     * Herakles - Die mees ekstreme redder
     * Hermes - Boodskapper van die gode
     * Hestia - Godin van die hart
     * Hours Sisters van Fates
     * Hyperion Die Titaan - Pa van Dawn
     * Hypnos Slaap - Broer van Thanatos
     * Io - Een van Hera se priesteresse wat deur Zeus in 'n vers verander
       is.
     * Iris - Die vinnige boodskapper
     * Kalypso - Die koningin nimf
     * Kronos - Leier van die Titane
     * Leto - Ma van Apollo en Artemis
     * Medusa - Die Gorgoon
     * Muses - Die Nege sisters
     * Nereids - Dogters van Nereus
     * Nike - Die godin van oorwinning
     * Odysseus - 'n Kennisvattende reisiger
     * Pan - Die god van skaapwagters en troppe, wilde bergdiere en die
       jag.
     * Persephone - Vrou vanHades
     * Poseidon - Die "Aardbewer" - god van aardbewings, die see en van
       perde.
     * Prometheus - 'n Slinkse Titaan wat vuur van Zeus gesteel het en aan
       die mense gegee het om te gebruik.
     * Rheia - Ma van die Olimpiads
     * Riviere in Die Iliad
     * Skylla - die gedierte met ses koppe
     * Thanatos - Die personifikasie van die dood en sterflikheid
     * Thetis - Ma van Achilleus
     * Winde - Die vier windgode, Sefier (of Zefuros), Boreas, Notos en
       Euros (daar is ook vier kleiner windgode)
     * Zeus - Die alfa van die onsterfbare

[wysig] Sien ook

     * Mite
     * Mitologie

   Kategorieë: Geskiedenis van Europa • Griekeland • Mitologie

