Pous Pius I


   Pous Pius I
   Pous Pius I

   Pius I was die tiende pous van die Rooms-Katolieke Kerk.

   Inhoud

        * 1 Biografie
        * 2 Pontifikaat
        * 3 Verering
        * 4 Webskakels
        * 5 Verwysings
        * 6 Nota

[wysig] Biografie

   Pous Pius I is in Illyrië gebore vermoedelik in die dorp Aquileia in
   Noord Italië en oorlede in 157 of 161. Die naam Pius beteken “Die
   Vrome”. In 140 of 146 volg hy Pous Higinus op en word na sy dood
   opgevolg deur Pous Anicetus. Sy vader se naam was Rufinus en sy broer
   Hermas. Hermas was waarskynlik die skrywer van Die Herder van Hermas.
   Hermas noem homself ‘n slaaf, dit versterk die vermoede dat Pius I self
   ‘n vrygelate slaaf was.

[wysig] Pontifikaat

   Hy word beskou as die oprigter van een van die oudste kerke in Rome die
   Santa Pudenziana. Hy het baie met die gnostisisme te kampe gehad.

[wysig] Verering

   Pius I sou met ‘n swaard vermoor gewees het. Hy word as martelaar en
   heilige vereer en word in die brevier genoem. Sy feesdag is 11 Julie.

[wysig] Webskakels

   CE Inskrywing in die Catholic Encyclopedia (Engels)

   BBKL Inskrywing (met Literatuurverwysings) in die
   Biographisch-Bibliographisches Kirchenlexikon (Duits)

[wysig] Verwysings

   Duchesne, (Ed.) Liber Pontificalis, I.

   Preuschen, (Ed.) Analecta I, Tubingen 1910

[wysig] Nota

   Saamgestel uit die Nederlandse, Engelse en Duitse wiki.

   Pouse van die Rooms-Katolieke Kerk

   Petrus - Linus - Anacletus I - Clemens I - Evaristus - Alexander I -
   Sixtus I - Telesforus - Higinus - Pius I - Anicetus - Soter - Eleuterus
   - Victor I - Zefirinus - Callixtus I - Urbanus I - Pontianus - Anterus
   - Fabianus - Cornelius - Lucius I - Stefanus I - Sixtus II - Dionisius
   - Felix I - Eutichianus - Gajus - Marcellinus - Marcellus I - Eusebius
   - Miltiades - Silvester I - Markus - Julius I - Liberius - Damasus I -
   Siricius - Anastasius I - Innocentius I - Zosimus - Bonifatius I -
   Celestinus I - Sixtus III - Leo I - Hilarius - Simplicius - Felix III -
   Gelasius I - Anastasius II - Simmachus - Hormisdas - Johannes I - Felix
   IV - Bonifatius II - Johannes II - Agapetus I - Silverius - Vigilius -
   Pelagius I - Johannes III - Benedictus I - Pelagius II - Gregorius I -
   Sabinianus - Bonifatius III - Bonifatius IV - Deusdedit - Bonifatius V
   - Honorius I - Severinus - Johannes IV - Theodorus I - Martinus I -
   Eugenius I - Vitalianus - Adeodatus - Donus - Agato - Leo II -
   Benedictus II - Johannes V - Konon - Sergius I - Johannes VI - Johannes
   VII - Sisinnius - Konstantyn - Gregorius II - Gregorius III - Sagarias
   - Stefanus II (III) - Paulus I - Stefanus III (IV) - Adrianus I - Leo
   III - Stefanus IV (V) - Paschalis I - Eugenius II - Valentinus -
   Gregorius IV - Sergius II - Leo IV - Benedictus III - Nicolaas I -
   Adrianus II - Johannes VIII - Marinus I - Adrianus III - Stefanus V
   (VI) - Formosus - Bonifatius VI - Stefanus VI (VII) - Romanus -
   Theodorus II - Johannes IX - Benedictus IV - Leo V - Sergius III -
   Anastasius III - Lando - Johannes X - Leo VI - Stefanus VII (VIII) -
   Johannes XI - Leo VII - Stefanus VIII (IX) - Marinus II - Agapetus II -
   Johannes XII - Leo VIII - Benedictus V - Johannes XIII - Benedictus VI
   - Benedictus VII - Johannes XIV - Johannes XV - Gregorius V - Silvester
   II - Johannes XVII - Johannes XVIII - Sergius IV - Benedictus VIII -
   Johannes XIX - Benedictus IX - Silvester III - Benedictus IX -
   Gregorius VI - Clemens II - Benedictus IX - Damasus II - Leo IX -
   Victor II - Stefanus IX - Nicolaas II - Alexander II - Gregorius VII -
   Victor III - Urbanus II - Paschalis II - Gelasius II - Callixtus II -
   Honorius II - Innocentius II - Celestinus II - Lucius II - Eugenius III
   - Anastasius IV - Adrianus IV - Alexander III - Lucius III - Urbanus
   III - Gregorius VIII - Clemens III - Celestinus III - Innocentius III -
   Honorius III - Gregorius IX - Celestinus IV - Innocentius IV -
   Alexander IV - Urbanus IV - Clemens IV - Gregorius X - Innocentius V -
   Adrianus V - Johannes XXI - Nicolaas III - Martinus IV - Honorius IV -
   Nicolaas IV - Celestinus V - Bonifatius VIII - Benedictus XI - Clemens
   V - Johannes XXII - Benedictus XII - Clemens VI - Innocentius VI -
   Urbanus V - Gregorius XI - Urbanus VI - Bonifatius IX - Innocentius VII
   - Gregorius XII - Martinus V - Eugenius IV - Nicolaas V - Callixtus III
   - Pius II - Paulus II - Sixtus IV - Innocentius VIII - Alexander VI -
   Pius III - Julius II - Leo X - Adrianus VI - Clemens VII - Paulus III -
   Julius III - Marcellus II - Paulus IV - Pius IV - Pius V - Gregorius
   XIII - Sixtus V - Urbanus VII - Gregorius XIV - Innocentius IX -
   Clemens VIII - Leo XI - Paulus V - Gregorius XV - Urbanus VIII -
   Innocentius X - Alexander VII - Clemens IX - Clemens X - Innocentius XI
   - Alexander VIII - Innocentius XII - Clemens XI - Innocentius XIII -
   Benedictus XIII - Clemens XII - Benedictus XIV - Clemens XIII - Clemens
   XIV - Pius VI - Pius VII - Leo XII - Pius VIII - Gregorius XVI - Pius
   IX - Leo XIII - Pius X - Benedictus XV - Pius XI - Pius XII - Johannes
   XXIII - Paulus VI - Johannes Paulus I - Johannes Paulus II - Benedictus
   XVI

   Teenpouse

   Hippolitus – Novatianus – Felix II – Ursinus – Eulalius – Laurentius –
   Dioscurus – Eugenius I - Theodorus II – Paschalis I – Theofilactus -
   Konstantyn II – Philippus – Johannes – Anastasius – Christoforus –
   Bonifatius VII – Donus II - Johannes XVI – Gregorius – Silvester III –
   Benedictus X – Honorius II – Clemens III – Theodoricus – Albertus –
   Silvester IV – Gregorius VIII – Celestinus II – Anacletus II – Victor
   IV – Paschalis III – Callixtus III – Innocentius III – Nicolaas V –
   Clemens VII – Benedictus XIII – Alexander V – Johannes XXIII – Clemens
   VIII – Benedictus XIV – Felix V

   Kategorieë: Pouse • Heiliges in die christendom

